/	main.views.articles.ListArticleView	articlesapp:list
/__debug__/render_panel/	debug_toolbar.views.render_panel	djdt:render_panel
/__debug__/sql_explain/	debug_toolbar.panels.sql.views.sql_explain	djdt:sql_explain
/__debug__/sql_profile/	debug_toolbar.panels.sql.views.sql_profile	djdt:sql_profile
/__debug__/sql_select/	debug_toolbar.panels.sql.views.sql_select	djdt:sql_select
/__debug__/template_source/	debug_toolbar.panels.templates.views.template_source	djdt:template_source
/admin/	django.contrib.admin.sites.index	admin:index
/admin/<app_label>/	django.contrib.admin.sites.app_index	admin:app_list
/admin/auth/group/	django.contrib.admin.options.changelist_view	admin:auth_group_changelist
/admin/auth/group/<path:object_id>/	django.views.generic.base.RedirectView
/admin/auth/group/<path:object_id>/change/	django.contrib.admin.options.change_view	admin:auth_group_change
/admin/auth/group/<path:object_id>/delete/	django.contrib.admin.options.delete_view	admin:auth_group_delete
/admin/auth/group/<path:object_id>/history/	django.contrib.admin.options.history_view	admin:auth_group_history
/admin/auth/group/add/	django.contrib.admin.options.add_view	admin:auth_group_add
/admin/auth/group/autocomplete/	django.contrib.admin.options.autocomplete_view	admin:auth_group_autocomplete
/admin/authapp/authapp/	django.contrib.admin.options.changelist_view	admin:authapp_authapp_changelist
/admin/authapp/authapp/<path:object_id>/	django.views.generic.base.RedirectView
/admin/authapp/authapp/<path:object_id>/change/	django.contrib.admin.options.change_view	admin:authapp_authapp_change
/admin/authapp/authapp/<path:object_id>/delete/	django.contrib.admin.options.delete_view	admin:authapp_authapp_delete
/admin/authapp/authapp/<path:object_id>/history/	django.contrib.admin.options.history_view	admin:authapp_authapp_history
/admin/authapp/authapp/add/	django.contrib.admin.options.add_view	admin:authapp_authapp_add
/admin/authapp/authapp/autocomplete/	django.contrib.admin.options.autocomplete_view	admin:authapp_authapp_autocomplete
/admin/basket/basket/	django.contrib.admin.options.changelist_view	admin:basket_basket_changelist
/admin/basket/basket/<path:object_id>/	django.views.generic.base.RedirectView
/admin/basket/basket/<path:object_id>/change/	django.contrib.admin.options.change_view	admin:basket_basket_change
/admin/basket/basket/<path:object_id>/delete/	django.contrib.admin.options.delete_view	admin:basket_basket_delete
/admin/basket/basket/<path:object_id>/history/	django.contrib.admin.options.history_view	admin:basket_basket_history
/admin/basket/basket/add/	django.contrib.admin.options.add_view	admin:basket_basket_add
/admin/basket/basket/autocomplete/	django.contrib.admin.options.autocomplete_view	admin:basket_basket_autocomplete
/admin/customers/customer/	django.contrib.admin.options.changelist_view	admin:customers_customer_changelist
/admin/customers/customer/<id>/password/	django.contrib.auth.admin.user_change_password	admin:auth_user_password_change
/admin/customers/customer/<path:object_id>/	django.views.generic.base.RedirectView
/admin/customers/customer/<path:object_id>/change/	django.contrib.admin.options.change_view	admin:customers_customer_change
/admin/customers/customer/<path:object_id>/delete/	django.contrib.admin.options.delete_view	admin:customers_customer_delete
/admin/customers/customer/<path:object_id>/history/	django.contrib.admin.options.history_view	admin:customers_customer_history
/admin/customers/customer/add/	django.contrib.auth.admin.add_view	admin:customers_customer_add
/admin/customers/customer/autocomplete/	django.contrib.admin.options.autocomplete_view	admin:customers_customer_autocomplete
/admin/images/image/	django.contrib.admin.options.changelist_view	admin:images_image_changelist
/admin/images/image/<path:object_id>/	django.views.generic.base.RedirectView
/admin/images/image/<path:object_id>/change/	django.contrib.admin.options.change_view	admin:images_image_change
/admin/images/image/<path:object_id>/delete/	django.contrib.admin.options.delete_view	admin:images_image_delete
/admin/images/image/<path:object_id>/history/	django.contrib.admin.options.history_view	admin:images_image_history
/admin/images/image/add/	django.contrib.admin.options.add_view	admin:images_image_add
/admin/images/image/autocomplete/	django.contrib.admin.options.autocomplete_view	admin:images_image_autocomplete
/admin/jsi18n/	django.contrib.admin.sites.i18n_javascript	admin:jsi18n
/admin/login/	django.contrib.admin.sites.login	admin:login
/admin/logout/	django.contrib.admin.sites.logout	admin:logout
/admin/main/author/	django.contrib.admin.options.changelist_view	admin:main_author_changelist
/admin/main/author/<path:object_id>/	django.views.generic.base.RedirectView
/admin/main/author/<path:object_id>/change/	django.contrib.admin.options.change_view	admin:main_author_change
/admin/main/author/<path:object_id>/delete/	django.contrib.admin.options.delete_view	admin:main_author_delete
/admin/main/author/<path:object_id>/history/	django.contrib.admin.options.history_view	admin:main_author_history
/admin/main/author/add/	django.contrib.admin.options.add_view	admin:main_author_add
/admin/main/author/autocomplete/	django.contrib.admin.options.autocomplete_view	admin:main_author_autocomplete
/admin/main/mainpagecontent/	django.contrib.admin.options.changelist_view	admin:main_mainpagecontent_changelist
/admin/main/mainpagecontent/<path:object_id>/	django.views.generic.base.RedirectView
/admin/main/mainpagecontent/<path:object_id>/change/	django.contrib.admin.options.change_view	admin:main_mainpagecontent_change
/admin/main/mainpagecontent/<path:object_id>/delete/	django.contrib.admin.options.delete_view	admin:main_mainpagecontent_delete
/admin/main/mainpagecontent/<path:object_id>/history/	django.contrib.admin.options.history_view	admin:main_mainpagecontent_history
/admin/main/mainpagecontent/add/	django.contrib.admin.options.add_view	admin:main_mainpagecontent_add
/admin/main/mainpagecontent/autocomplete/	django.contrib.admin.options.autocomplete_view	admin:main_mainpagecontent_autocomplete
/admin/ordersapp/order/	django.contrib.admin.options.changelist_view	admin:ordersapp_order_changelist
/admin/ordersapp/order/<path:object_id>/	django.views.generic.base.RedirectView
/admin/ordersapp/order/<path:object_id>/change/	django.contrib.admin.options.change_view	admin:ordersapp_order_change
/admin/ordersapp/order/<path:object_id>/delete/	django.contrib.admin.options.delete_view	admin:ordersapp_order_delete
/admin/ordersapp/order/<path:object_id>/history/	django.contrib.admin.options.history_view	admin:ordersapp_order_history
/admin/ordersapp/order/add/	django.contrib.admin.options.add_view	admin:ordersapp_order_add
/admin/ordersapp/order/autocomplete/	django.contrib.admin.options.autocomplete_view	admin:ordersapp_order_autocomplete
/admin/ordersapp/orderitem/	django.contrib.admin.options.changelist_view	admin:ordersapp_orderitem_changelist
/admin/ordersapp/orderitem/<path:object_id>/	django.views.generic.base.RedirectView
/admin/ordersapp/orderitem/<path:object_id>/change/	django.contrib.admin.options.change_view	admin:ordersapp_orderitem_change
/admin/ordersapp/orderitem/<path:object_id>/delete/	django.contrib.admin.options.delete_view	admin:ordersapp_orderitem_delete
/admin/ordersapp/orderitem/<path:object_id>/history/	django.contrib.admin.options.history_view	admin:ordersapp_orderitem_history
/admin/ordersapp/orderitem/add/	django.contrib.admin.options.add_view	admin:ordersapp_orderitem_add
/admin/ordersapp/orderitem/autocomplete/	django.contrib.admin.options.autocomplete_view	admin:ordersapp_orderitem_autocomplete
/admin/password_change/	django.contrib.admin.sites.password_change	admin:password_change
/admin/password_change/done/	django.contrib.admin.sites.password_change_done	admin:password_change_done
/admin/products/category/	django.contrib.admin.options.changelist_view	admin:products_category_changelist
/admin/products/category/<path:object_id>/	django.views.generic.base.RedirectView
/admin/products/category/<path:object_id>/change/	django.contrib.admin.options.change_view	admin:products_category_change
/admin/products/category/<path:object_id>/delete/	django.contrib.admin.options.delete_view	admin:products_category_delete
/admin/products/category/<path:object_id>/history/	django.contrib.admin.options.history_view	admin:products_category_history
/admin/products/category/add/	django.contrib.admin.options.add_view	admin:products_category_add
/admin/products/category/autocomplete/	django.contrib.admin.options.autocomplete_view	admin:products_category_autocomplete
/admin/products/product/	django.contrib.admin.options.changelist_view	admin:products_product_changelist
/admin/products/product/<path:object_id>/	django.views.generic.base.RedirectView
/admin/products/product/<path:object_id>/change/	django.contrib.admin.options.change_view	admin:products_product_change
/admin/products/product/<path:object_id>/delete/	django.contrib.admin.options.delete_view	admin:products_product_delete
/admin/products/product/<path:object_id>/history/	django.contrib.admin.options.history_view	admin:products_product_history
/admin/products/product/add/	django.contrib.admin.options.add_view	admin:products_product_add
/admin/products/product/autocomplete/	django.contrib.admin.options.autocomplete_view	admin:products_product_autocomplete
/admin/products/productmarker/	django.contrib.admin.options.changelist_view	admin:products_productmarker_changelist
/admin/products/productmarker/<path:object_id>/	django.views.generic.base.RedirectView
/admin/products/productmarker/<path:object_id>/change/	django.contrib.admin.options.change_view	admin:products_productmarker_change
/admin/products/productmarker/<path:object_id>/delete/	django.contrib.admin.options.delete_view	admin:products_productmarker_delete
/admin/products/productmarker/<path:object_id>/history/	django.contrib.admin.options.history_view	admin:products_productmarker_history
/admin/products/productmarker/add/	django.contrib.admin.options.add_view	admin:products_productmarker_add
/admin/products/productmarker/autocomplete/	django.contrib.admin.options.autocomplete_view	admin:products_productmarker_autocomplete
/admin/r/<int:content_type_id>/<path:object_id>/	django.contrib.contenttypes.views.shortcut	admin:view_on_site
/admin/social_django/association/	django.contrib.admin.options.changelist_view	admin:social_django_association_changelist
/admin/social_django/association/<path:object_id>/	django.views.generic.base.RedirectView
/admin/social_django/association/<path:object_id>/change/	django.contrib.admin.options.change_view	admin:social_django_association_change
/admin/social_django/association/<path:object_id>/delete/	django.contrib.admin.options.delete_view	admin:social_django_association_delete
/admin/social_django/association/<path:object_id>/history/	django.contrib.admin.options.history_view	admin:social_django_association_history
/admin/social_django/association/add/	django.contrib.admin.options.add_view	admin:social_django_association_add
/admin/social_django/association/autocomplete/	django.contrib.admin.options.autocomplete_view	admin:social_django_association_autocomplete
/admin/social_django/nonce/	django.contrib.admin.options.changelist_view	admin:social_django_nonce_changelist
/admin/social_django/nonce/<path:object_id>/	django.views.generic.base.RedirectView
/admin/social_django/nonce/<path:object_id>/change/	django.contrib.admin.options.change_view	admin:social_django_nonce_change
/admin/social_django/nonce/<path:object_id>/delete/	django.contrib.admin.options.delete_view	admin:social_django_nonce_delete
/admin/social_django/nonce/<path:object_id>/history/	django.contrib.admin.options.history_view	admin:social_django_nonce_history
/admin/social_django/nonce/add/	django.contrib.admin.options.add_view	admin:social_django_nonce_add
/admin/social_django/nonce/autocomplete/	django.contrib.admin.options.autocomplete_view	admin:social_django_nonce_autocomplete
/admin/social_django/usersocialauth/	django.contrib.admin.options.changelist_view	admin:social_django_usersocialauth_changelist
/admin/social_django/usersocialauth/<path:object_id>/	django.views.generic.base.RedirectView
/admin/social_django/usersocialauth/<path:object_id>/change/	django.contrib.admin.options.change_view	admin:social_django_usersocialauth_change
/admin/social_django/usersocialauth/<path:object_id>/delete/	django.contrib.admin.options.delete_view	admin:social_django_usersocialauth_delete
/admin/social_django/usersocialauth/<path:object_id>/history/	django.contrib.admin.options.history_view	admin:social_django_usersocialauth_history
/admin/social_django/usersocialauth/add/	django.contrib.admin.options.add_view	admin:social_django_usersocialauth_add
/admin/social_django/usersocialauth/autocomplete/	django.contrib.admin.options.autocomplete_view	admin:social_django_usersocialauth_autocomplete
/api/basket/delete/	basket.api.basket.rest_basket_delete	rest_basket:rest_delete
/api/basket/detail/	basket.api.basket.rest_basket_detail	rest_basket:rest_detail
/api/basket/list/	basket.api.basket.rest_basket_list	rest_basket:rest_list
/api/basket/update/	basket.api.basket.rest_basket_update	rest_basket:rest_update
/api/categories/detail/<int:pk>/	products.api.categories.rest_category_detail	rest_categories:rest_detail
/api/categories/list/	products.api.categories.rest_category_list	rest_categories:rest_list
/api/orders/create/	ordersapp.api.orders.OrderCreateView	rest_ordersapp:rest_create_order
/api/products/basket/	products.api.products.rest_basket_json	rest_products:rest_basket
/api/products/create/	products.api.products.rest_product_create	rest_products:rest_create
/api/products/delete/<int:pk>/	products.api.products.rest_product_delete	rest_products:rest_delete
/api/products/detail/<int:pk>/	products.api.products.rest_product_detail	rest_products:rest_detail
/api/products/list/	products.api.products.rest_product_list	rest_products:rest_list
/api/products/update/<int:pk>/	products.api.products.rest_product_update	rest_products:rest_update
/auth/login/	authapp.views.LogInView	authapp:login_view
/auth/logout/	authapp.views.LogOutView	authapp:logout_view
/auth/oauth2/complete/<backend>/	social_django.views.complete	social:complete
/auth/oauth2/disconnect/<backend>/	social_django.views.disconnect	social:disconnect
/auth/oauth2/disconnect/<backend>/<association_id>/	social_django.views.disconnect	social:disconnect_individual
/auth/oauth2/login/<backend>/	social_django.views.auth	social:begin
/auth/signin/	authapp.views.SignInView	authapp:logup_view
/auth/verify/	authapp.views.verify	authapp:verify
/authors/create/	main.views.authors.CreateAuthorView	authorsapp:create
/authors/delete/<int:pk>/	main.views.authors.DeleteAuthorView	authorsapp:delete
/authors/detail/<int:pk>/	main.views.authors.DetailAuthorView	authorsapp:detail
/authors/list/	main.views.authors.ListAuthorView	authorsapp:list
/authors/update/<int:pk>/	main.views.authors.UpdateAuthorView	authorsapp:update
/basket/add_product/<int:pk>/	basket.views.add_product	basketapp:add_product
/basket/add_product_ajax/<int:pk>/	basket.views.add_product_ajax	basketapp:add_product_ajax
/basket/basket/	basket.views.basket	basketapp:basket
/basket/delete_product_ajax/<int:pk>/	basket.views.delete_product_ajax	basketapp:delete_product_ajax
/basket/remove_product_ajax/<int:pk>/	basket.views.remove_product_ajax	basketapp:remove_product_ajax
/categories/category/<int:pk>/	products.views.categories.CategoryListOfView	categoriesapp:category
/categories/create/	products.views.categories.CategoryCreateView	categoriesapp:create
/categories/detail/<int:pk>/	products.views.categories.CategoryDetailView	categoriesapp:detail
/categories/list/	products.views.categories.CategoryListView	categoriesapp:list
/categories/update/<int:pk>/	products.views.categories.CategoryUpdateView	categoriesapp:update
/contacts/	contacts.views.contacts	contactsapp:contacts
/create/	main.views.articles.CreateArticleView	articlesapp:create
/customer/create/	customers.views.CustomerCreateView	customersapp:create
/customer/delete/<int:pk>/	customers.views.CustomerDeleteView	customersapp:delete
/customer/detail/<int:pk>/	customers.views.CustomerDetailView	customersapp:detail
/customer/edit_profile/<int:pk>/	customers.views.edit_profile	customersapp:edit_profile
/customer/list/	customers.views.CustomerListView	customersapp:list
/customer/update/<int:pk>/	customers.views.CustomerUpdateView	customersapp:update
/delete/<int:pk>/	main.views.articles.DeleteArticleView	articlesapp:delete
/detail/<int:pk>/	main.views.articles.DetailArticleView	articlesapp:detail
/framework_api/	rest_framework.routers.APIRootView	api-root
/framework_api/\.<format>/	rest_framework.routers.APIRootView	api-root
/framework_api/products/	products.api.products.ProductViewSet	product-list
/framework_api/products/<pk>/	products.api.products.ProductViewSet	product-detail
/framework_api/products/<pk>\.<format>/	products.api.products.ProductViewSet	product-detail
/framework_api/products\.<format>/	products.api.products.ProductViewSet	product-list
/framework_api_auth/login/	django.contrib.auth.views.LoginView	rest_framework:login
/framework_api_auth/logout/	django.contrib.auth.views.LogoutView	rest_framework:logout
/images/create_image/	images.views.create_image	imagesapp:create_image
/images/delete_image/<int:pk>/	images.views.delete_image	imagesapp:delete_image
/images/detail_image/<int:pk>/	images.views.detail_image	imagesapp:detail_image
/images/list_image/	images.views.list_image	imagesapp:list_image
/images/update_image/<int:pk>/	images.views.update_image	imagesapp:update_image
/media\/<path>	django.views.static.serve
/myshopadmin/	myshopadmin.views.index	myshopadminapp:index
/myshopadmin/<app>/<model>/	myshopadmin.views.ModelList	myshopadminapp:list
/myshopadmin/<app>/<model>/<pk>/	myshopadmin.views.ModelDetail	myshopadminapp:detail
/myshopadmin/<app>/<model>/create/	myshopadmin.views.ModelCreate	myshopadminapp:create
/myshopadmin/<app>/<model>/delete/<pk>/	myshopadmin.views.ModelDelete	myshopadminapp:delete
/myshopadmin/<app>/<model>/update/<pk>/	myshopadmin.views.ModelUpdate	myshopadminapp:update
/orders/	ordersapp.views.OrderListView	ordersapp:list
/orders/basket/	ordersapp.views.storage	ordersapp:storage
/orders/create/	ordersapp.views.OrderCreateView	ordersapp:create
/orders/delete/<int:pk>/	ordersapp.views.OrderDeleteView	ordersapp:delete
/orders/detail/<int:pk>/	ordersapp.views.OrderDetailView	ordersapp:detail
/orders/update/<int:pk>/	ordersapp.views.OrderUpdateView	ordersapp:update
/products/catalog/	products.views.products.Catalog	productsapp:catalog
/products/create/	products.views.products.ProductCreateView	productsapp:create
/products/delete/<int:pk>/	products.views.products.ProductDeleteView	productsapp:delete
/products/detail/<int:pk>/	products.views.products.ProductDetailView	productsapp:detail
/products/list/	products.views.products.ProductListView	productsapp:list
/products/update/<int:pk>/	products.views.products.ProductUpdateView	productsapp:update
/update/<int:pk>/	main.views.articles.UpdateArticleView	articlesapp:update
